###################################################################
#.................................................................#
#.................................................................#
#.................................................................#
#.................................................................#
#.................................................................#
#...................###...####....................................#
#...................#........#....................................#
#...................#...@....#....................................#
#...................##########....................................#
#.................................................................#
#.................................................................#
#.................................................................#
#.................................................................#
#.................................................................#
#.................................................................#
###################################################################